	R 1080 640
NO   ./textures/bluestone.xpm
SO ./textures/south.xpm
WE ./textures/west.xpm
EA ./textures/east.xpm


F  05,30,0

C  00,100,0

S ./textures/pillar.xpm


11111111111111111111111111111
10000000001100002000000000001
10110000011102000000000010001
10010000000000002000000010001
10110000011100020200000010011
10000000001100000111011110001
11110111111111011100000010001
11110111111111011101010010001
11000000110101011100000010001
10000000000000001100000010201
10000000000000001101010010001
10000000000000001101010010N01
11000000110101011111011110001
11110111111101011111011110001
11111111111111111111111111111
10000000000000001100000010001
10000000000000001101010010001
11111111111111111111111111111
