	R 1080 640
NO   ./textures/bluestone.xpm
SO ./textures/south.xpm
WE ./textures/west.xpm
EA ./textures/east.xpm


F  05,30,0

C  00,100,0

S ./textures/pillar.xpm


11111111111111111111111111111
10000022201100002000000000001
10110200011102000000000010001
10012020000000002000000010001
10112000011100020200000010011
10000000001100000111011110021
11110111111111011100000012001
11110111111111011101010010021
11000000110101011100000010201
10000000000000001100000010001
10000000000000001101010010001
10000000000000001101010010N01
11000000110101011111011110001
11110111111101011111011110001
   1111111111111111111111111111
11110000000000001100000010001
10000000000000001101010010001
11111111111111111111111111111
