	R 1080 640
NO   ./textures/bluestone.xpm
SO ./textures/south.xpm
WE ./textures/west.xpm
EA ./textures/east.xpm


F  05,30,0

C  00,100,0

S ./textures/pillar.xpm


        111111111111111111111111
        1000000000110000000000111
        10110000011100000020001
        1001000000000000000000111
111111111011000001110000000000001
100000000011000001110111111111111
11110111111111011100000010001
11110111111111011101010010001
11000000110101011100000010001
10002000000000001100000010001
10000000000000001101010010001
11000001110101011111011110N0111
11110111111101011101111010001
11111111111111111111111111111
