1111111111
1000000001
1000020001
100000W001
111111111111
1111111111
1000000001
1000020001
1000000001
1111111111110001


--

1111111111
1000000001
1000020001
100000W001
1111111111110001

--
