R 640 480
NO   ./textures/bluestone.xpm
SO ./textures/south.xpm
WE ./textures/west.xpm
EA ./textures/east.xpm


F  225,30,0

C  220,100,0

S ./textures/pillar.xpm





        11111111111111 1111111111
        10000000001101 1000000001
        1011000001110111000200111
        10010000000000000000001
111111111011000001110000000000111
100000000011000001110111111111111
11110111111111011100000010001
11110111111111011101010010001
11000000110101011100000010001
10000000000000001100000010001
11100000000000001101010010001
  100001110101011111011110N0111
11110111 1110101 101111010001
11111111 1111111 111111111111
