S ./textures/pillar.xpm
R 900 600
NO ./textures/north.xpm
SO ./textures/south.xpm
WE ./textures/west.xpm
EA ./textures/east.xpm
F 184,113,39
C 51,198,227

1111111
10000001
110111001
1111  1001
1001 1001
100N00001
100000001
111111111
