R 640 480
NO   ./textures/north.xpm
SO ./textures/south.xpm
WE ./textures/west.xpm
EA ./textures/east.xpm


F  0 , 0 ,0

C  0,0,50

S ./textures/pillar.xpm


111111111111111111111111111
100000000011000000000000001
100000000000000000000000011
1111011111101011N1111010001
111111111111111111111111111
