R 1600 700
NO   ./textures/north.xpm
SO ./textures/south.xpm
WE ./textures/west.xpm
EA ./textures/east.xpm


F  0 , 0 ,0

C  0,0,50

S ./textures/pillar.xpm


10000000000000001101010010001
11000001110101011111011110N0111
11110111 1110101 101111010001
11111111 1111111 111111111111
